image_width: 512
image_height: 512
tile_size: 16
map_width: 30
map_height: 20
layer_count: 1

layer0: 2,2,2,5,2,5,2,5,2,5,2,5,2,5,2,5,2,5,2,5,2,5,2,5,2,5,2,5,2,2,
34,34,34,38,34,38,34,38,34,38,34,38,34,37,34,37,34,38,34,38,34,38,34,38,34,38,34,38,34,34,
34,195,130,71,130,71,130,71,130,71,130,71,130,69,130,69,130,71,130,71,130,71,130,71,130,71,131,71,194,34,
34,130,130,130,130,130,130,130,130,130,130,130,130,131,130,130,130,130,130,130,130,130,130,130,130,130,130,131,130,34,
34,130,130,131,130,130,130,130,130,130,130,130,130,130,130,130,130,130,130,130,130,130,130,130,131,130,130,130,130,34,
34,130,130,130,130,130,130,130,131,130,130,130,131,130,130,130,131,130,130,130,131,130,130,130,130,130,130,130,130,34,
34,130,130,132,130,130,130,130,130,130,130,130,130,130,130,130,130,130,130,130,130,130,130,130,130,130,130,130,130,34,
34,130,130,130,130,130,130,130,130,130,130,130,130,130,130,130,130,130,130,130,130,130,130,130,130,130,131,130,130,34,
34,130,130,130,130,130,130,130,130,130,130,130,130,130,130,130,130,130,130,130,130,130,130,130,130,130,130,130,130,34,
34,130,130,130,130,130,130,131,130,130,130,130,130,130,132,130,130,130,130,130,132,130,130,130,130,130,130,130,130,34,
34,130,130,130,130,130,130,130,130,130,130,130,130,130,131,130,130,130,130,130,130,130,131,130,130,130,130,130,130,34,
34,130,130,132,130,130,130,130,130,130,132,130,130,130,130,130,131,130,130,130,130,130,130,130,130,130,130,130,130,34,
34,130,130,130,131,130,130,130,130,130,130,130,130,130,130,130,130,130,130,130,130,130,130,130,130,130,130,130,130,34,
34,130,130,130,130,130,130,131,130,130,130,130,131,130,130,130,130,130,130,130,130,130,130,130,130,130,130,130,130,34,
34,130,130,130,130,130,130,130,130,130,130,130,130,130,130,130,130,130,130,130,130,130,130,130,130,130,130,130,130,34,
34,130,130,130,130,130,130,130,130,131,130,130,130,130,130,131,130,130,130,130,130,130,130,130,130,130,131,130,130,34,
34,130,130,132,130,130,130,130,130,130,130,130,130,130,130,130,130,130,130,131,130,130,130,130,130,130,130,130,130,34,
34,130,130,130,130,130,130,130,130,130,130,130,130,130,130,130,130,130,130,130,130,130,130,130,130,130,130,130,130,34,
34,162,130,130,130,130,130,130,130,130,130,130,130,130,130,130,130,130,130,130,130,130,130,130,130,130,130,130,164,34,
34,34,34,34,34,34,34,34,34,34,34,34,34,34,34,34,34,34,34,34,34,34,34,34,34,34,34,34,34,34